222222222222222
255525552555252
252525252525252
152P25252525651
252525252525252
252555255525552
222222222222222