22222122222
25255555552
25252522252
25252555252
25222522252
25555555592
22222P22222
25255555552
25252522252
25252555652
25222522252
25555555592
22222122222