22222222222222222
25552225555555552
25255555252225552
25556225552225P52
25555555552555552
22222222222222222